#####################
#A#               #  #
#   ############# # #
# #           #   # #
# # ######### ### # #
# #   #     #   #   #
# ### # ##### ### # #
#     #       #   # #
# ### ##### ### ### #
#     #     #       #
##### # ########### #
#     #           # #
# ### ######### # # #
# #         #   # # #
# ######### ##### # #
#           #     # #
###################B#
